8,8,8,8,8,4,4,4,4,4,4,4,4,4,4,4,4,4,4,4,4,4,4,4,4,4,4,4,4,4,4,4,4,4,4,4,4,4,4,4,4,4,4,4,4,4,4,4,4,4,4,4,4,4,4,4,4,4,4,4
8,8,8,8,8,8,4,4,4,4,4,4,4,4,4,4,4,4,4,4,4,4,4,4,4,4,4,4,4,4,4,4,4,4,4,4,4,4,4,4,4,4,4,4,4,4,4,4,4,4,4,4,4,4,4,4,4,4,4,4
8,8,0,8,8,8,8,8,8,8,8,4,4,4,4,4,4,4,4,4,4,4,4,4,4,3,3,4,4,4,3,3,3,3,4,4,4,4,4,4,4,4,4,4,4,4,4,4,4,4,4,4,4,4,4,4,4,4,4,4
8,0,0,0,8,8,8,8,8,8,8,8,8,3,3,3,4,4,4,4,4,4,4,3,3,3,3,3,3,3,3,3,3,3,3,4,4,4,4,4,4,4,4,4,4,4,4,4,4,4,4,4,4,4,4,4,4,4,4,4
8,0,0,0,0,0,0,0,8,8,8,8,8,0,3,3,3,8,8,4,4,8,8,3,3,0,0,3,3,3,0,0,0,3,3,4,4,4,4,4,4,4,4,4,4,4,4,4,4,4,4,4,4,4,4,4,4,4,4,4
8,0,0,0,0,0,0,0,0,8,8,8,0,0,0,0,3,8,8,8,8,8,0,0,0,0,0,0,0,0,0,0,0,3,3,4,4,4,4,4,4,4,4,4,4,4,3,3,4,4,4,4,4,4,4,4,4,4,4,4
8,8,0,0,0,0,0,0,0,8,8,0,0,0,0,0,0,6,8,8,8,8,0,0,0,0,0,0,0,0,0,0,0,0,3,3,4,4,4,4,4,4,4,4,4,4,3,3,3,3,3,4,4,4,4,4,4,4,4,4
8,8,8,0,0,0,0,0,0,0,0,0,0,0,0,6,6,6,6,8,8,8,0,0,0,0,0,0,0,0,0,0,0,0,3,3,4,4,4,4,4,4,4,4,4,3,3,0,3,3,3,3,4,4,4,4,4,4,4,4
8,8,8,8,8,0,0,0,0,0,0,0,0,0,0,6,6,6,0,0,8,8,0,0,0,0,0,0,0,0,0,0,0,0,3,3,4,4,4,4,4,4,4,4,3,3,0,0,0,0,0,3,3,3,3,4,4,4,4,4
8,8,8,8,8,0,0,0,0,0,0,0,0,0,0,0,6,6,6,8,8,0,0,0,0,0,0,0,0,0,0,0,0,0,0,3,3,4,4,4,4,4,4,3,3,0,0,0,0,0,0,0,3,3,3,4,4,4,4,4
8,8,8,8,8,0,0,0,0,0,0,0,0,0,0,0,0,6,8,8,8,0,0,0,0,0,0,0,0,0,0,0,0,0,0,0,3,3,8,8,3,3,3,3,0,0,0,0,0,0,0,0,0,0,3,3,4,4,4,4
8,8,8,8,8,0,0,0,0,0,0,0,0,0,0,0,0,8,8,8,8,0,0,0,0,0,0,0,0,0,0,0,0,0,0,0,8,8,8,8,8,3,3,0,0,0,0,0,0,0,0,0,0,0,3,3,4,4,4,4
8,8,8,6,0,0,0,0,0,0,0,0,0,0,0,0,0,8,8,8,8,8,0,0,0,0,0,0,0,0,0,0,0,0,0,0,0,8,8,8,8,6,6,0,0,0,0,0,0,0,0,0,0,0,0,3,8,8,4,4
8,0,8,6,0,0,0,0,0,0,0,0,0,0,0,0,0,8,8,8,8,8,0,0,0,8,8,8,0,0,0,0,0,0,0,0,8,8,8,8,8,6,6,6,0,0,0,0,0,0,0,0,0,0,0,6,8,8,8,4
8,6,6,0,0,0,0,0,0,0,0,0,0,8,0,0,0,0,8,8,8,8,0,0,0,8,8,8,0,0,0,0,0,0,0,8,8,8,8,8,0,0,6,6,0,0,0,0,0,0,0,0,0,0,6,6,8,8,8,8
8,6,6,6,0,0,0,0,0,0,0,0,8,8,8,0,0,0,8,8,8,8,0,0,0,0,8,0,0,0,0,0,0,0,0,8,8,8,8,8,8,8,6,0,0,0,0,0,0,0,0,0,0,0,6,6,8,8,8,8
8,8,6,6,0,0,0,0,0,0,0,8,8,8,8,8,0,8,8,8,8,0,0,0,0,0,0,0,0,0,0,0,0,0,0,0,8,8,8,8,8,8,0,0,0,0,0,0,0,0,0,0,0,0,0,6,8,8,8,8
8,8,8,6,0,0,0,0,0,0,8,8,8,8,8,8,8,8,8,8,8,0,0,0,0,0,0,0,0,8,8,8,8,0,0,0,0,8,8,8,8,8,8,0,0,0,0,0,0,0,8,8,8,0,0,0,0,8,8,8
8,8,8,0,0,0,0,0,0,0,8,8,8,8,8,8,8,8,8,8,8,0,0,0,0,0,0,0,8,8,8,8,8,8,0,0,8,8,8,8,8,8,8,8,0,0,8,8,0,8,8,8,8,8,0,0,0,8,8,8
8,8,8,0,0,0,8,8,0,0,0,8,8,8,8,8,8,8,8,8,8,8,0,0,8,8,0,8,8,8,8,8,8,8,0,0,8,8,8,8,8,8,8,8,0,8,8,8,8,8,8,8,8,8,8,0,8,8,8,8
8,8,8,0,0,0,8,8,8,0,0,0,8,8,8,8,8,8,8,8,8,8,8,8,8,8,8,8,8,0,8,8,8,0,0,0,8,8,8,8,8,8,8,8,0,8,8,8,8,8,8,8,8,8,0,0,8,8,8,8
8,8,8,0,0,0,8,8,8,8,0,0,0,8,8,8,8,8,8,8,8,8,8,8,8,8,8,8,0,0,0,8,0,0,0,0,0,8,8,8,8,8,8,8,0,0,8,8,8,8,8,8,0,0,0,0,8,8,8,8
8,8,8,0,0,8,8,8,8,0,0,0,0,0,0,0,8,8,8,8,8,8,6,6,8,8,0,0,0,0,0,0,0,0,0,0,0,0,8,8,8,8,8,8,0,0,0,8,8,8,0,0,0,0,0,0,0,8,8,8
8,8,8,0,8,8,8,8,0,0,0,0,0,0,0,0,0,0,0,0,0,0,6,6,6,6,0,0,0,3,3,3,3,0,0,0,0,6,8,8,8,8,8,0,0,0,0,0,0,0,0,0,0,0,0,0,0,0,8,8
8,8,0,0,8,8,8,8,0,0,8,8,0,0,0,0,0,0,0,8,8,6,6,6,6,0,0,0,3,3,4,4,4,3,0,0,6,6,6,8,8,8,0,0,0,0,0,0,0,0,0,0,0,0,0,8,8,8,0,8
8,8,0,0,0,8,8,8,8,8,8,8,8,0,0,0,0,8,8,8,8,8,6,6,0,0,0,3,4,4,4,4,3,0,0,0,6,6,6,8,8,8,8,0,0,0,0,0,0,0,0,0,0,0,6,8,8,8,8,8
8,0,0,0,0,0,8,8,8,8,8,0,0,0,0,0,8,8,8,8,8,8,8,0,0,0,0,0,3,3,4,3,3,0,0,0,0,6,8,8,8,8,8,0,0,0,0,0,0,0,0,0,0,0,6,6,8,8,8,8
8,0,0,0,0,0,0,8,8,8,0,0,0,0,0,0,8,8,8,8,8,8,8,0,0,0,0,0,0,3,3,3,0,8,8,0,0,0,0,8,8,8,0,0,0,0,0,0,0,0,0,0,0,6,6,6,8,8,8,8
8,0,0,0,0,0,0,0,0,0,0,0,0,0,0,0,0,8,8,8,8,8,8,0,0,8,8,0,0,0,0,0,8,8,8,8,0,0,0,0,0,0,0,0,0,0,0,0,0,0,0,0,0,0,6,6,8,8,8,8
8,0,0,0,0,0,0,0,0,0,0,0,0,0,0,0,0,8,8,8,8,8,0,0,0,8,8,8,0,0,0,8,8,8,8,8,0,8,8,8,8,0,0,0,0,0,0,0,0,0,0,0,0,0,6,8,8,8,8,8
8,8,0,0,0,0,0,0,0,0,0,0,0,0,0,0,0,0,0,0,0,0,0,0,8,8,8,8,0,0,8,8,8,8,8,8,8,8,8,8,8,8,0,0,0,0,0,0,0,0,0,0,0,0,0,0,8,8,8,8
8,8,8,0,0,0,0,0,0,0,0,0,0,0,0,0,0,0,0,8,8,8,8,0,8,8,8,8,0,0,0,8,8,8,8,8,8,8,8,8,8,0,0,0,8,0,0,0,0,0,0,0,0,0,0,0,0,8,8,8
8,8,0,0,0,0,0,0,0,0,0,0,0,0,0,0,8,8,8,8,8,8,8,8,8,8,8,8,0,0,0,0,0,8,8,8,8,8,8,8,8,0,0,8,8,8,0,0,0,0,0,0,0,0,0,0,0,8,8,8
8,0,0,0,0,0,0,0,0,0,0,0,0,8,8,8,8,8,8,8,8,8,8,8,8,6,0,0,0,0,0,0,0,0,0,8,8,8,8,8,8,8,8,8,8,0,0,0,0,0,0,0,0,0,0,0,0,8,8,8
8,0,0,0,0,0,0,0,0,0,8,8,8,8,8,8,0,8,8,8,8,8,8,6,6,6,0,0,0,0,6,6,0,0,0,0,8,8,8,8,8,8,8,8,8,0,0,0,0,0,0,0,0,0,0,0,0,8,8,8
8,0,0,0,0,0,0,0,0,0,8,8,8,6,6,6,0,8,8,8,8,8,6,0,6,0,0,0,0,6,6,6,6,6,0,0,0,0,0,0,0,0,0,0,0,0,0,0,0,0,0,0,0,0,0,0,8,8,8,8
8,0,0,0,0,8,0,0,0,0,0,0,0,0,6,6,6,8,8,8,8,8,0,0,0,0,0,0,6,6,6,6,6,6,6,6,0,0,0,0,0,0,0,0,0,0,6,6,6,0,0,0,0,0,0,8,8,8,8,8
8,0,0,0,8,8,8,8,0,0,0,0,0,0,0,0,6,6,8,8,8,0,0,0,8,8,0,0,0,0,6,6,6,6,0,0,0,0,8,8,0,0,0,0,8,8,8,6,6,6,0,0,0,0,8,8,8,8,8,8
8,8,0,8,8,8,8,8,8,8,0,0,0,0,0,0,0,0,0,0,0,0,0,8,8,8,8,0,0,0,0,0,0,0,0,0,0,8,8,8,8,0,0,8,8,8,8,8,6,6,6,0,0,0,0,8,8,8,8,8
8,8,8,8,8,8,8,8,8,8,8,8,8,8,8,8,8,8,8,8,8,8,8,8,8,8,8,8,8,8,0,0,0,0,8,8,8,8,8,8,8,8,8,8,8,8,8,8,8,8,8,8,8,8,8,8,8,8,8,8
